map0
00000000000000000000
00000000000000000000
00000000000000000000
00000000011111000000
00000000010001000000
00000001110001000000
00000001000011000000
00000011000010000000
00000010000010000000
00000010000010000000
00000011111110000000
00000000000000000000
00000000000000000000
00000000000000000000
00000000000000000000

map1
00000000000000000000
00000000000000000000
00000000000000000000
00000000000000000000
00000000011111000000
00000011110001000000
00000010000001000000
00000010100111000000
00000010000001000000
00000011110001000000
00000000011111000000
00000000000000000000
00000000000000000000
00000000000000000000
00000000000000000000